27,8,15,15,15,8,15,15,15,8,15,15,15,8,15,15,15,8
15,15,15,8,15,15,15,8,15,15,15,8,15,15,15,8,15,15
15,8,15,15,15,8,15,15,15,8,15,15,15,8,15,15,15,8
15,15,15,8,15,15,15,8,15,15,15,8,15,15,15,8,15,15
15,8,15,15,15,8,15,15,15,8,15,15,15,8,15,15,15,8
15,15,15,8,15,15,15,8,15,15,15,8,15,15,15,8,15,15
15,8,15,15,15,8,15,15,15,8,15,15,15,8,15,15,15,8
15,15,15,8,15,15,15,8,15,15,15,8,15,15,15,8,15,15
15,8,15,15,15,8,15,15,15,8,15,15,15,8,15,15,15,8
15,15,15,8,15,15,15,8,15,15,15,8,15,15,15,8,15,15
15,8,15,15,15,8,15,15,15,8,15,15,15,8,15,15,15,8
15,15,15,8,15,15,15,8,15,15,15,8,15,15,15,8,15,34
