27,15,8,15,15,15,15,15,8,15,15,15,15,15,8,15,15,15
15,15,8,15,15,8,15,15,8,15,15,8,15,15,8,15,8,15
15,15,8,15,15,8,15,15,8,15,15,8,15,15,8,15,15,8
15,15,15,15,15,8,15,15,15,15,15,8,15,15,15,15,15,8
8,8,8,8,8,8,8,8,8,8,8,8,8,8,8,8,15,15
15,15,15,15,15,15,15,15,15,15,15,15,15,15,15,15,15,15
8,15,8,8,8,8,8,8,8,8,8,8,8,8,8,8,8,8
8,15,15,15,15,15,8,15,15,15,15,15,8,15,15,15,15,15
15,15,15,15,15,15,8,15,15,15,15,15,8,15,15,15,15,15
15,15,15,8,15,15,8,15,15,8,15,15,8,15,15,8,15,15
15,8,15,8,15,15,15,15,15,8,15,15,15,15,15,8,15,15
8,8,15,8,15,15,15,15,15,8,15,15,15,15,15,8,15,34
,,,,,,,,,,,,,,,,,
,,,,,,,,,,,,,,,,,
,,,,,,,,,,,,,,,,,
27,0,0,0,0,0,1,0,0,0,0,2,0,0,0,0,0,3
0,0,0,0,0,0,0,0,0,0,0,0,0,0,0,0,0,33
0,0,0,0,0,0,0,0,0,2,0,0,0,0,0,0,0,0
0,0,0,1,0,0,22,0,0,0,0,0,0,0,1,0,0,0
0,0,0,0,0,0,0,0,0,0,0,0,0,0,0,0,0,0
3,0,0,0,0,0,0,0,0,0,0,0,0,0,0,0,0,0
0,0,0,0,0,0,0,0,0,0,0,0,0,0,0,0,0,0
0,0,0,0,0,0,0,0,0,0,0,0,0,1,0,2,0,3
2,0,0,0,0,0,0,0,0,2,0,0,0,0,0,0,0,0
0,0,0,0,0,0,0,0,0,0,0,0,0,0,0,0,0,0
0,0,0,0,0,0,2,0,0,0,0,0,3,0,0,0,0,0
0,0,44,0,0,0,0,0,0,0,0,0,0,0,0,0,1,34
